Roots
A
1. acid acri acrid,	14．anc, anti = old
acu = sour, sharp	ancient	a. 古代的
acidity	n. 酸度，酸性	antique	a.	古代的 n. 古物
acute	a. 尖锐的
acme	n. 顶点，顶峰

2.acro = top		15．anim = life, spirit acrobat	n. 杂技演员		animal	n. 动物
acrophobia	n. 恐高症	animate	v. 使有生气，活泼

3.act =to do, to drive	16．ann, enn = year
activity	n. 活动	annual	a. 一年一度的
enact	v. 实施，颁布	anniversary	n. 周年纪念
exact	a. 精准的 v. 苛求，强求

4.aer, aero, aeri = air	17．anthrop = man, human aerology	n. 气象学，大气学		anthropology	n. 人类学
aerosphere	n. 大气层内外空间	philanthropist	n. 博爱主义者
aerodrome	n. 飞机场

5.ag = to do, to act	18．apt, ept = to fit, ability
agenda	n. 议事日程	aptitude	n. 适应能力，才能
agency	n. 代理处	adapt	v.使适应，适应环境 coagent		n. 合作者

6.agon = struggle	19. aqu = water
agony	n. 痛苦	aquarium	n. 水族馆
agonize	v. 感到痛苦	aqueduct	n. 引水槽

7.agri, agro, agr = field, land	20．arbit = to judge agriculture	n. 农业		arbiter	n. 仲裁人，泰斗 agrobiology		n. 农业生物学		arbitrary		a. 武断的

8.alb = white		21．arch, archy = ruler, rule, chief albescent	a. 发白的		anarchy	n. 无政府状态
albinism	n. 白化病	monarch	n. 君主，帝主

9.alt = high	22．arm = weapon
altitude	n. 高度	disarm	v. 解除武器
exalt	v. 升高，赞扬	armament	n. 兵器

10.alter, ali = other, to change	23．art = skill, joint, trick

alteration	n. 改造，改变	artful	a. 巧妙的，狡猾的
alternative	n. 二者择一	artifice	n. 技巧，诡计
alien	a. 外国的，外来的	artificial	a. 人工的

11.am, amor = love	24．astro, aster = star amateur	n. 业余爱好者		astronaut	n. 宇航员
amour	n. 男女爱情	astrophysics	n. 天体物理学

12．ambul = to walk			25．audi, audit =to hear ambulance	n. 救护车，流动医院	audience	n. 听众，观众 circumambulate		v. 环行，绕…而行 auditorium		n. 礼堂，讲堂 somnambulate	v. 梦游，梦行

13．ample = large	26．aug = to increase amplify	v. 放大，扩大		augment	v. 增大
amplitude	n. 广大	augmentation	n. 增大，扩大

27．av, avar, avi = desire, bird avarice	n. 贪心 aviculture	n. 养鸟业
B
1.	ball, bol = to throw, dance, ball	8.	bibli = book
balloon	n. 气球	bibliography	n.	书目提要
bullet	n. 枪弹	bible	n. 圣经

2.	balm = balsam
balmy	a. 芬芳的，温和的
embalm	v. 保存，铭记	9.	bio, bi = life biology	n. 生物
biography	n. 传记

3．	
ban = to prohibit banish	v. 驱逐出境
abandon	v. 抛弃，放弃	
10.	
blanc = white blank	a. 空白的
blanch	v.	漂白，发白

4．	
bar = weight， stick baric	a. 气压的 barometer	n. 气压计 barrier		n. 栅栏
barrage	n. 阻塞， 遮断	
11.	
brace = two arms bracelet	n. 手镯
embrace	v.	拥抱，包括

5．	
bas, base =low, foundation basement	n.	地下室	
12.	
braid = to twist braid	v. 编成辫子
bass	a/n. 低音的	upbraid	v. 谴责
abase	v. 降低

6． bat = to beat	13.	brev, bridg = short
batter	v. 连续猛打		brevity	n. 短暂，简洁
combat	n. 战斗		abridge	v. 删节，削减

7． bell, bel = war, to fight rebellion	n. 反叛，反抗 rebel	v. 反叛

C
1.cad, cas, cid = to fall	24.		calor = heat casual	a. 偶然的		calorie	n. 热卡 occasion		n. 事情的发生，时机		 calorify		v. 加热 incident		n. 偶然事件
accidental	a. 偶然的

2.cand = white, glow	25.	camp = field candela	n. 烛光		 campus	n. 校园
candle	n. 蜡烛	campaign	n. 战役

3.cant, cent = song, to sing	26.	car, char = dear
chant	n. 圣歌，赞美歌	charity	n. 慈爱，慈善
cantata	n. 清唱剧	cherish	v. 珍爱
accent	n. 口音，重音
accentuate	v. 强调， 重读

4.cap, capt, cept, ceive, cip	27.	card, chart = paper cup = to take, to hold			chart	n. 图表
capacity	n. 容量，才能	charter	n. 特许状，契约
captive		n. 俘虏 capture		 v. 捉拿 accept	v. 接受，承认 receive		v. 接受，收到
anticipate		v. 预料，预期 participate		v. 参加，共享 occupy	v. 占领，使用 occupation			n. 职业，占有

5.cap, cipit = head	28.	cav = hole capital	a./n. 首要的，首都，资本		 cave	n. 洞穴
captain	n. 首领，船长	excavate	v. 挖掘
capitation	n. 人头税，丁税

6.card, cord = heart	29.		cens = to judge cardiac	a. 心脏的		censor	n. 审查员

cordial	a. 真诚的	censure	n. 责难
accord	n. 一致，符合，协调

7． carn = flesh		30.	chor = to dance, to sing
carnage	n.	屠杀		chorus	n. 合唱（队）
carnation	a. 肉色的 n. 康乃馨	choreography	n. 舞蹈设计
carnival	n. 狂欢节，谢肉节	choir	n. 合唱队

8.	ced, ceed, cess = to go	31.	chrom = color
antecedent	 a. 先行的， 以前的	monochrome	a. 单色的 ancestor	 n. 祖先，祖宗	 chromatic	a. 彩色的 concede	v. 让步，容许
precede	 v. 在先，优于 proceed		v. 继续进行，前进 process	n.	过程，进行

9.	celer = quick, speed accelerate	v. 加速，加快
decelerate	v. 减速	32.	cil = to call
conciliate	v. 安慰，劝诱
reconcile	v. 和解

10．cent = hundred century	n. 世纪
percentage	n. 百分率	
33.	
civ = citizen civil	a. 市民的
civilization	n. 文明

11．center, centr = center concentrate	v. 集中， 浓缩
concentric	a. 同心的，集中的	
34.	
coct = to cook
concoct	v. 编造，虚构
decoct	v. 煎， 熬

12．cern, cert, cret = sure	35.	cogn = to know
concern	v. 关系到 n. 关心	cognition	n. 认知， 认识
certainty	n. 确实，确定	recognize	v. 认出
discreet	a. 慎重的，谨慎的

13．chron = time	36.	cosm(o) = world
chronic	a. 长期的		cosmos	n. 宇宙
chronology	n. 年表		microcosm	n. 微观世界

14.cid, cis = to cut, to kill	37.	crit, cris = to judge, to discern insecticide	n. 杀虫剂		criticism	n. 批评
suicide	n. 自杀	criterion	n. 标准
incise	v. 切割，雕刻
precise	a. 精确的

15.circ, cycl = ring, circle	38.	cryo = cold

circular	a. 圆的，循环的	cryobiology	n. 低温生物学
bicycle	n. 自行车	cryoprotective	a. 防冷冻的
encyclopedia	n. 百科全书
encircle	v. 环绕，包围

16．cit = to quote, to call	39.	custom = habit
excite	v. 兴奋，刺激		customary	a. 习惯性的
incite	v. 鼓励，煽动		accustom	v. 使习惯
recite	v. 背诵		

17.claim, clam = cry out, shout	40.	 cur, curs, cour, cours = to run acclaim	v. 欢呼，喝彩		concur	v.	同时发生
declaim	v. 朗诵，演说	currency	n. 流传，流通货币
exclaim	v. 叫喊，大声说	concourse	n. 汇合， 合流
proclaim	v. 公布，声明	excurse	v. 远足， 旅游
clamor	n. 喧哗，吵闹

18.clear, clar, clair = clear, bright	41．cur = to care
clarify	v. 澄清，弄清	secure	a. 安全的
declare	v. 宣言， 断言	curious	a. 好奇的

19.clin, cliv = to lean, slope	42．cult = to till decline	v. 倾斜，衰退		culture	n. 文化
incline	v. 倾向，偏向	cultivate	v. 耕作，培养
recline	v. 斜靠，歇躺	aquiculture	n. 水产养殖

20.clos, clud, clus = to close	43．cub, cumb = to lie down enclose	v. 包围，围绕		succumb	v. 屈服，死亡
exclude	v. 排除，隔绝	encumber	v. 妨害，阻碍
include	v.	包括	incubate	v. 孵卵，伏巢

21.corp, corpor = body	44．crypt = secret, hidden
corpse	n. 尸体	cryptogram	n. 密码，暗号
corporation	n. 公司，团体	cryptonym	n. 匿名
corporal	a. 肉体的	cryptic	a. 秘密的

22.cracy, crat = to rule, ruler	45．cru, crus, curx = to cross democracy	n. 民主政治		crucial	a. 关键的，十字形的
autocrat	n. 独裁者	cruciform	a./n. 十字形的
theocracy	n. 神权统治 monocracy			n. 独裁统治 mobocrat		n. 暴民首领

23.creed, cred = to believe,	46．cre, crease = to grow, to make to trust		create	v. 创造
creditable	a. 可以信任的	increase	v. 增加
credible	a. 可靠的， 可信的	procreate	v.	繁殖，生产
discredit	v. 不信任， 怀疑
credulous	a. 轻信的

D	
1.	demn = harm	11.	don, dit = to give
	condemn	v. 谴责，指责		donate	v. 捐赠
	indemnity	n. 赔偿		edit	v. 编辑

2.dem(o) = people	12.	dom = house
democracy		n. 民主	dome	n. 圆屋顶，大厦 demography		n. 人口统计学	 domestic	a. 家里的， 国内的 epidemic	a. 流行的，传染性的
pandemic	a. 广泛流行的

3.dens = to make thick	13.	dorm = to sleep
dense	a. 浓密的	dormitory	n. 寝室，宿舍
condense	v. 浓缩	dormant	a. 休眠的，冬眠的

4.dent = tooth	14.	draw = to pull
dentist	n. 牙医	drawl	v. 拉长语调说话
denture	n. 假牙	withdraw	v. 撤回，缩回

5.derm, dermat = skin	15.	 drom = to run dermatitis	n. 皮炎		aerodrome	n. 飞机场
dermatologist	n. 皮肤病学家	dromometer	n. 速度计
epidermis	n. 表皮，外皮

6．dexter = right	16.	 du, dub, dou = two dexterous	a. 灵巧的，敏捷的		dual	a. 二重的，二元的
ambidexterous	a. 非常灵巧的	double	a. 双倍的

7．di = day	17.	duc, duct = to lead, to bring diary	n. 日记			deduce	v. 推论
introduce	v. 介绍， 引进
8．dict, dicat = to say, to assert	produce	v. 生产
dictate	v. 听写，口授 dictionary	n. 字典 dictum	 n. 格言，断言 benediction		n. 祝福

9．dign = worthy, noble
dignity	n. 威严，庄严
indignity	n. 轻视，侮辱	18.	dur = last, hard durable	a. 持久的
endure	v. 持久，耐久

10. doc, doct = to teach doctor	n. 医生，博士 doctrine		n. 教条， 教义 document		n. 文件	
19.	
dyn, dynam = power dynasty	n.		王朝 dynamics		n. 动力学

E
1.	ed = to eat		6.		 erg, ert = energy, to work edible	a. 可吃的， 食用的			energy	n. 能量 inedible		a. 不可吃的		energetic		a. 充满活力的

2．ego = I			7.	err = to wander, mistake
egoism	n.	利己主义		error	n. 错误
egocentric	a. 自我中心的	erratic	a. 古怪的
aberrant	a. 越轨的
3.em, amp, empt = to take, to procure	8.	esthet =feeling example	n. 榜样，例子		 aesthetics	n. 美学
sample	n. 样品，标本	anesthesia	n. 麻醉
exempt	v. 免除

4.emper, imper = to command	9.	 extr = out emperor	n. 皇帝		extra	a. 额外的
imperative	a. 命令的， 强制的	external	a. 外部的
imperial	a. 帝国的

5.equ, equi = equal, even	10.	ev = age
equality	n. 平等	primeval	a. 原始的
equation	n. 方程式	medieval	a. 中世纪的
equity	n. 公平，公正
equivalent	a. 相等的，等价的

F	
1.	fabl, fabal = to speak	18.	flect, flex = to bend
	fable	n. 寓言， 传说		inflect	v. 使弯曲
	affable	a. 温和的，和蔼的		reflect	v. 反射，沉思
2.	fabric = to make		flexible	a. 易弯曲的
	fabricate	v. 制作，捏造		
prefabricated	a. 预制的

3.	fac, fic = face	19.	flict = to strike
face	n. 脸	afflict	v. 使苦恼，折磨

facetious	a. 轻浮的	conflict	v. 冲突，斗争
preface	n. 前言，序言	infliction	n. 痛苦，负担

4.	fac, fact, fect, fic, fig
= to make, to do
facile	a. 容易做的 facilitate	v. 使容易 benefaction	n. 善事，恩惠 malefaction	 n. 罪恶，犯罪	20.	flor, flour = flower
floral a. 花的，似花的 floriculture n. 花卉栽培 flourish v. 繁荣，兴旺

5．fall, fail, fault = err, to deceive failure	n. 失败
fault	n. 过失，缺点
fallible	a. 易错的	
21.	
flu = to flow
fluid	n. 流动， 液体
flux	n.	流动，变迁

6．feder = league
federal	a. 联盟的，联邦的
confederate	a. 联合的	
22.	
forc, fort = strong
force	n. 力量，强制力
reinforce	v. 加强，巩固

7．fer = to bring, to carry	23.	form = shape
circumference	n. 四周，周围	formal	a. 正式的，正规的
conference	n. 商量，会议	formation	n. 形成，培养
offer	v. 提供，贡献	formula	n. 公式，信条

8．ferv = boil
fervid	a. 热情的
perfervid	a. 十分热情的	24.	found, fund = base foundation	n. 基础，地基
founder	n. 奠基者

9.	fess = to speak
confess	v. 承认，坦白
professor	n. 教授	
25.	
fract, frag = to break fraction	 n.	部分，小片 fracture	n. 骨折，断裂

10.fest = to strike; feast	26.	frig = cold
infest	v. 大批出没，扰乱	frigid	a. 寒冷的
manifest	a. 明白的，显然的	refrigerator	n. 冰箱
festival	n. 节日，宴会
festive	a. 节日的

11.fid = to trust, faith	27.	 front = forehead confide	v. 吐露， 信托		affront	v. 冒犯
confidence	n. 自信，信任	confront	v. 面临，对抗
confidential	a. 秘密的，机密的

12.fil = thread	28.	fug = to flee

filament	n. 细线	fugitive a/n. 逃亡的，短暂的，逃亡者
profile	n. 外形，轮廓	centrifugal	a. 离心的
file	n. 行列，档案	insectifuge	n. 驱虫药
filar	a. 线状的

13．fin = to end, boundary	29. fus = to pour
finish	v. 完成，结束	confuse	v. 使混乱
finite	a. 有限的	confusion	n. 混乱
infinite	a. 无限的	diffuse	v. 散播
effuse	v. 流出， 泻出
14．firm = firm	effusion	n. 流出，吐露
infirm	a. 虚弱的	refuse	v. 拒绝
affirm	v. 断言，证实
confirm	v. 确认，证实

15.fix = to fix fixation		n. 固定 affix	n. 附加，贴上 prefix		 n. 前缀 suffix		n. 后缀

16.flam, flagr = blaze flame	n. 火焰
inflame	v. 燃烧，发怒，红肿

17.flat = to blow
inflate	v. 充气，膨胀 inflation		n. 充分，通货膨胀 conflation		n. 合并，合成

G
1.gam = marriage	9. grad = step, grade neogamist	n. 新婚者		grade	n. 等级，阶级
monogamy	n. 一夫一妻制	graduate	v. 毕业
degrade	v. 降级， 退化

2.gar = to furnish	10. gram, graph = to write garment	n. 衣服，外衣		biography	n. 传记文学
garnish	v. 装饰，加配菜	telegraph	n. 电报

3.gen, genif = birth, to produce	11. gran = grain
generate	v. 产生， 发电	granary	n. 粮仓，谷仓
generation	n. 一代	granivorous	a. 食谷的
genesis	n. 起源，创始

4.geo = earth	12. grat, gree = pleasing geography	n. 地理学		gratitude	n. 感激，感恩
geometry	n. 几何学	gratification	n. 满足，喜悦

5．germ = seed	13. grav, griev = heavy
germane	a. 关系密切的	grave	a. 重大的， 庄重的
germinate	v. 发芽，发育	aggravate	v. 加重，恶化，激怒
grief	n. 悲伤
6.gest, gister = to carry, to bring	14. greg = group
gesture	n. 手势，姿势	aggregate	v. 聚集，合加
congest	v. 拥挤，稠密	congregate	v. 聚集
digest	v. 消化，摘要
suggest	v. 建议，提议

7.glaci = ice	15. gress = to go, to walk glacier	n. 冰川		aggression	n. 侵略，攻击
glaciology	n. 冰川学	congress	n. 国会，代表大会
progress	n. 进步， 进行
8.gnos, gnor = to know	16. gyn, gyneco = woman ignore	v. 疏忽，不理睬		gynecology	n. 妇科学
ignorance	n. 无知，愚昧	monogyny	n. 一夫一妻制
agnostic	a. 不可知论的

H
1.	habit = to dwell	8. her, hes = to stick habitant		n. 居住者		adhere	v. 粘着， 依附
inhabit	v. 居住	coherent	a. 连贯的，有条理的
hesitation	n. 犹豫
2．hal = to breathe	9. hibit = to hold
inhale	v. 吸气	exhibition	n. 展览，表演
exhale	v.	呼气	inhibit	v. 禁止，阻止
prohibit	v. 阻止，禁止
3． hap = chance	10. hilar = glad
happen	v. 发生	hilarity	n. 高兴，欢乐
mishap	n. 不幸	exhilarate	v. 使高兴

4．hav = to possess	11. hor = to shudder, dread have	v. 有		horrid	a. 可怕的
behave	v. 举动， 举止	horrible	a. 可怕的

5.head = head	12. hospit = guest
heading	n. 标题	hospitality	n. 好客，殷勤
heady	a. 轻率的	host	n. 主人

6.heli(o) = sun	13. hum = earth heliocentric	a. 以太阳为中心的		 inhume	v. 埋葬 heliosis		n. 中暑		exhume	 v. 掘出
human	n. 人类
7.helic(o) = to spiral	14. hydr, hydro = water
helicopter	n. 直升飞机	hydrous	a. 含水的，水壮的
helix	n. 螺旋线	hydroelectric	a. 水利发电的

15. hypno = to sleep hypnology	n. 催眠学
dehypnotize	v. 解除催眠

I.
1.	idea, ideo	= idea	5. insul = island
ideal	n. 理想	peninsula	n. 半岛
idealism	n. 理想主义	insular	a. 岛国的

2．idio = peculiar, private	6. integr = whole
idiot	n. 白痴，傻子	integrity	n. 完整，完全
idiograph	n. 个人签字	disintegration	n. 瓦解

3.idol = image	7. it = to go
idol	n. 偶像	exit	n. 出口， 出去
idolize	v. 崇拜	circuit	n. 环行，电路

4.imag, imit = likeness imagine	v. 想像 imitable	 a. 模仿

J
1.	 ject = to throw, to cast	5. junct, join = to join project	v. 投射，放映		joint	n. 关节，连接
eject	v. 喷出，.驱逐	disjoin	v. 分开，折断
inject	v. 注射

2．joc = joke	6. jur = to swear, law jocose	a. 滑稽的， 可笑的		jury	n. 陪审团
jocular	a. 爱开玩笑的	abjure	v. 发誓放弃

3．journ = day	7. juven = young
journal	n. 日报，杂志	juvenile	a. 青少年的
journalist	n. 记者	rejuvenation	n. 返老还童

4. jud, judg = to judge
judgment	n. 判断，判断力
prejudge	v. 预先断定

L
1.labor = labor	17. limin, lim = threshold laborious		 a. 辛苦的，吃力的		 eliminate	v. 除去，删除 laboratory		n. 实验室		preliminary		a. 预备的 elaborate		v. 精工细做
a. 精心制作的

2.lact = milk	18. line = line
lactic	a. 乳汁的	outline	n. 轮廓，大纲
lactate	v. 分泌乳汁	underline	v. 强调，在字下划线

3．langu = faint	19. lingu = language
languish	v. 倦怠，衰弱	linguistics	n. 语言学
languor	n. 衰弱，憔悴	bilingual	a. 两种语言

4．laps = to slip	20. linqu = to leave
lapse	v. 慢慢沉下，掉下	delinquent	a. 有过失的
n. 失误	relinquish	v. 放弃，放开
elapse	v. 时光流失

5.lat = bring out	21. liter = letter
translate	v. 翻译	illiterate	a. 文盲的
collate	v. 校对	literature	n. 文学

6.later = side	22. lith = stone
unilateral	a. 单边的	paleolithic	a. 旧石器时代的
bilateral	a. 双边的	neolithic	a. 新石器时代的

7.lav, luv, lut = to wash	23. loc = place
lavish	v. 浪费	local	a. 地方的， 局部的
dilute	v. 冲淡	location	n. 位置，场所
deluge	n. 大洪水

8.lax = loose	24. log, logu = to speak
laxity n. 松弛	dialogue	n. 对话
relax	v. 放松，宽心	prologue	n. 开场白

9.lect, lig = to choose, to gather	25. logy = science
collect	v. 收集	morphology	n. 形态学
election	n. 选举	psychology	n. 心理学

select	v. 选择

10.lect, leg = to speak, to read	26. long = long
lecture	n. 讲座	longevity	n. 长寿
idiolect	n. 个人方言	prolong	v. 延长
acrolect	n. 上流语言

11.leg, legis = law	27. loqu, locu = to speak legal	a. 法律的		colloquial	a. 口语的
legislation	n. 立法	elocation	n. 雄辩

12.lev, live = to raise, to lighten	28. luc, lust = light, shine elevator	v. 电梯		lucidity	n. 光明，明白
lever	n. 杠杆	luster	n. 光泽，光彩
relieve	v. 减轻，解除

13.liber = free	29. lumin = light
liberty	n. 自由	illuminate	v. 照亮，阐明
liberal	a. 自由的，慷慨的	luminous	a. 发亮的

14．libr = book	30. lud, lus = to play
library	n. 图书馆	allude	v. 提及， 暗指
elude	v. 躲避，使困倦
15.lic = to allure	31. lun = moon delicate	a. 可口的		lunar	a. 月亮的
elicit	v. 引出，得出	semilunar	a. 半月形的

16.licen = to allow
licence	n. 特许，许可证
licentious	a. 放肆的

M
1. magn = big	19. mir = wonder
magnificence	n. 宏大，庄严	miracle	n. 奇迹
magniloquent	a. 吹牛的	miraculous	a. 奇迹般的

2．maj = great	20. mis (o) = hate
major	a. 较大的 主要的	misanthropist	n. 厌世者
majority	n. 大多数	misogamist	n. 厌恶结婚者

3．man = hand	21. mob = move
manual	a. 手工的； n. 手册		mobile	a. 活动的，可动的 manuscript	n. 手稿	mobility		n. 能动性 manufacture		v. 制造，加工

4.man, main = stay	22. mod = mode, manner permanent	a. 持久的，不变的		modest	a. 谦虚的
remain	v. 剩余，遗留	moderate	a. 适度的
modify	v. 修改
5.mar = sea		23. mon, monit = to warn marine	a. 海的		monitor	n. 忠告，警告
submarine	n. 潜水艇	admonish	v. 训诫，警告

6.mark = sign	24. monstr = to show marked	a. 有记号的		monster	n. 怪物
landmark	n. 里程碑	demonstrate v.证明，示威游行

7.mater, matr = mother	25. morph = to form, to shape maternal	a. 母亲的		amorphous	a. 不定形的
matriarchy	n.母系制	morphology	n. 形态学

8.med, medi = middle	26. mort = death
medial	a. 中间的，平均的	mortal	a. 死的，致命的
mediate	v. 调停 a. 中间的	immortal	a. 不朽的
medium	n. 媒介物

9.mend = free from fault	27. mot = to move amend	v. 改正，改过		motion	n. 运动
emend	v. 改正， 校订	motivate	v. 推动， 激励
promote	v. 促进，提升
10．memor = memory	28. mount = to ascend memory	n. 记忆，记忆力		mount	v. 登上
remember	v. 回忆，记住	mountain	n. 山

11．ment = mind	29. mun = public mental	a. 智力的，精神的		commune	n. 公社
mentality	n. 智力，精神	community	n. 社区
mention	v. 提到，论及

12.merc, merch = trade	30. mur = wall
commerce	n. 商业	mural	a. 墙壁的 n. 壁画
merchant	n. 商人	immure	v. 监禁，禁闭

13.merg, mers = to sink	31. mus = muse
emerge	a. 浮现，出现	museum	n. 博物馆
submerge	v. 沉入，沉入水中	music	n. 音乐
merge	v. 合并	amuse	v. 娱乐
14.meter, metr, meas, mens = to measure	32. mut = change

diameter	n. 直径	mutable	a.	易变的
perimeter	n. 周长	mutability	n. 易变
dimension	n. 大小，面积

15．migr = to remove migrate	v. 迁移，移住 immigrate		v. 移居入境

16．milit = soldier militant	a. 好战的
military	a. 军人的，军队的

17．min = to project
eminent	a. 杰出的， 突出的
prominent	a. 突出的，显著的

18．mini = small diminish	v. 减少，缩小
minor	a. 较少的，较小的
minority	n. 少数

N
1.nat = born		10. nom(y) = a field of knowledge natal	a. 诞生的			astronomy		n. 天文学 nationality	n. 国民性，国籍		agronomy	n. 农学
native	a. 故乡的，本地的

2.nav, naut = ship	11. nomin = to name
navy	n. 海军	nominate	v. 提名，任命
navigate	v. 驾驶，航海	denominate	v. 给命名

3.nect, nex = to bind	12. norm = to rule, norm
connect	v. 连结	normal	a. 正常的
disconnect	v. 拆开，分离	abnormal	a. 异常的

4．neg,ni = to deny	13. nost =home
deny	v. 否认，拒绝	nostalgia	n. 思乡病
neglect	n. 忽视，不顾	nostrum	n. 民间药，秘药方

5. negr, nigr = black	14. not = to know
negro	n. 黑人	notable	a. 值得注意的
denigrate	v. 抹黑	notice	v. n. 注意，通知

6．neur = nerve	15. nounce, nunci = to speak

neurology	n. 神经病学	announce	v. 宣布，发表
neuropath	n. 神经病患者	denounce	v. 抨击，指责
pronounce	v. 发音
7.nihil = nothing	16. nov = new
nihil	n. 虚无，毫无价值	novelty	n. 新奇事情
nihilism	n. 虚无主义	innovation	n. 革新，改革

8.noct = night	17. null = none
noctambulate		v. 梦游	null	a.无效的，等于零的 pernoctation	n. 整夜不归（不眠）	 annul		v. 取消，废除

9.noc, nox = to hurt	18. numer =number
innocent	a. 无害的，天真的	numerous	a. 数目众多的
nocuous	a. 有毒的	enumerate	v. 列举，点数

19. nutri = nourish
nutrition	n. 营养
nutrient	n. 营养品

O
1. oner = load			7. orbit = circle onerous	a. 繁重的，费力的			orbit	n. 轨道 exonerate		v. 免除，无罪释放		orbital		a. 轨道的 onus	n. 负担，责任

2．onym = name		8. ori, orig = to rise, to begin onymous	a. 有名字的		 oriental	a. 东方的 anonymous		a. 无名的，匿名的		original	 a. 起源的

3．oper =	to work	9. ordin = order
operation	n. 操作，手术	ordain	n. 规定，命令
cooperation	n. 合作	coordinate	v. 协作 a. 同等的

4．opt = to choose; sight	10. orn = embellish optional	a. 可任意选择的		adorn	v. 装饰
adopt	v. 采纳，收养	ornament	n. 装饰品
optic	a. 眼的，视力的
optics	n. 光学

5．optim = best	11. ot(o) =ear
optimism	n. 乐观主义	otology	n. 耳科学
optimistic	a. 乐观的	otopathy	n. 耳病

6. ora = mouth

orator	n. 演说家
oral	a. 口头的

P
1.par = equal；to bring forth	29. ple, plen, pli = full, to fill parity	n. 同等，同样		complement	n. 补充，补全
imparity	n. 不平等	supplement	n. 增补
parent	n. 父母
multiparous	a. 多产的，多胎的

2.par, pear = to come in sight	30. plex = to fold
apparent	a. 明显的	complex	a. 复杂的
appear	v. 出现	duplex	a. 二重的
disappear	v. 消失

3．parl = to speak	31. plic, ply = to fold
parley	n. 谈判，会谈	complicate	v. 弄复杂
parliament	n. 国会	implicate	v.	牵连，含蓄表达

4．part, port = part, divide	32. plor = to cry, to weep
apartment	n. 公寓	deplore	v. 悲叹，痛惜
depart	v.	离开	explore	v. 探索，钻研
		implore	v. 恳求，乞求

5．pass = to pass through; feeling	33. point, punct = point, make sharp passage	n. 通过，通行		pointer	n. 指针，指示者
passport	n. 护照	punctual	a. 准时的
passion	n. 激情
compassion	n. 同情

6. path, pathy = feeling, suffering	34. polic, polis, polit = state, city sympathy	n. 同情		polis	n. 古希腊城邦
pathology	n. 病理学	metropolis	n. 大都市
cosmopolis	n. 国际都市

7．patri = father	35. pon = to put patriarchy	n. 父权政治		postpone	v. 推迟
patriotism	n. 爱国主义	opponent	a.对立的 n.对手

8．ped = foot, child, education	36. popul = people biped	a. 双足动物的 n. 双足动物		population		n. 人口 expedition		n. 远征，探险			popular	a. 流行的 pedology	n.	儿科学
pedant	n. 书呆子

pedagogy	n. 教学法

9.pel, puls = to drive, to push	37. port = to carry
compel	v. 强迫	portable	a. 可携带的
expel	v. 开除，驱逐	porter	n. 搬运工
impel	v. 推进，驱动

10.pen, pun = penalty	38. pos, posit = to put penalty	n. 惩罚		pose	v. 作姿态
penitent	a. 后悔的	compose	v. 组成， 作曲

11.pend, pens = to hang	39. post = behind pendant	n. 垂饰		posterior	a. 以后的
suspend	v. 悬吊，停止	posterity	n. 后代
suspense	n. 悬念

12.pend, pens, pond = weight, to expend
expend	v. 花费	40. poten = powerful expensive	a. 很贵的		potent	a. 强有力的
ponder	v. 沉思	potential	n. 潜力
ponderous	a. 笨重的，重的

13．peri = to try	41. prais, preci = value peril	v. 冒险 n.危险		appraise	v. 评价
perilous	a. 危险的	precious	a. 珍贵的
experience	n. 经验，经历	appreciate	v. 评价，欣赏
experiment	n. 实验

14.pet = to seek	42. prehen = to catch
petition	n. 请愿，申请	apprehension	n. 理解，忧虑
compete	v. 竞争，竞赛	comprehend	v.了解，理解， 包括

15.petr(o) = stone	43. press = to press petroleum	n. 石油		pressing	a. 急迫的
petrochemistry	n. 石油化学	pressure	n. 压力
compress	v.	压缩，缩短
16.phag = to eat	44. prim = first, chief
zoophagous	a. 吃动物的，食肉的	primary	a. 最初的，根本的
dysphagia	n. 下咽困难	primitive	a. 原始的

17.phil = to love	45. pris = to take philanthropy	n. 博爱		apprise	v. 通知，报告
zoophilous	a. 爱护动物的	comprise	v. 包括，含有
18.phob, phobia = to dislike	46. priv = single, alone

hydrophobia	n. 恐水症	private	a.	私人的
acrophobia	n. 恐高症	privilege	n. 特权

19．phon = sound	47. proach = near symphony	n.交响乐		approach	v. 接近
microphone	n. 麦克风	approachable	a. 易接近的

20．photo = light	48. prob, prov = to test
photograph	n. 照片	approve	v. 赞成
photogenic	a. 生物发光的	disprove	v. 不赞成， 证明为假

21．phyto = plant	49. prol = offspring
hydrophyte	n. 水生植物	prolific	a. 多产的，多育的
phytogeography	n. 植物地理学	proliferate	v. 繁殖，激增

22. pict = to paint	50. proper, propri = one’s own picture	n. 图画，照片		property	n. 所有物，特性
picturesque	a. 风景如画的	appropriate	v. 拨款，挪用

23．pisc = fish	51. pugn = to fight piscary	n. 捕鱼场		impugn	v. 责难
pisciculture	n. 养鱼业	pugnacious	a. 好斗的

24. plac = calm	52. pur, purg = pure
placid	a. 平静的	purity	n. 纯净，纯正
implacable	a. 不平静的	impure	a.不纯的

25．place = place	53. put = to think displace	v. 移位，顶替		compute	v. 计算
replace	v. 代替	computer	n. 计算机
dispute	v. 反驳
26．plat = flat
plateau	n. 平顶，高原
platform	n. 月台，讲台

27．plant = plant
plantation	n. 大农场，造林
implant	v. 播种，插入

28．plaud = to clap hands applaud	v. 拍手喝彩 applause		n. 鼓掌

Q

1.quaint = to know	4. quit = free
acquaint	v. 使了解，告知	quit	v. 停止，放弃
acquaintance	n. 了解，熟悉	acquit	v. 开释，免罪

2.quest, quir, quis, quer
= to seek, to search question	n. 疑问
request	v/n. 要求，恳求
acquire	v.	获取

3.quiet, quies = still quietude	n. 安静
acquiescence	n. 默认，默许

R
1. radic = root	8. rod, ros = to bite
radical	a. 根本的， 激进的	corrode	v. 腐蚀
eradicate	v. 根除，消灭	erode	v. 侵蚀

2．rage = mad	9. rog = to ask
rage	n. 狂怒	arrogate	v. 霸占
outrage	n. 暴行，残暴	interrogate	v. 审问

3．range = rank	10. rot = wheel
arrange	v. 安排	rotate	v. 旋转
derange	v. 扰乱，使混乱	rotund	a. 圆形的，圆胖的
disarrange	v. 弄乱

4.rap, rapt, rav = to snatch	11. rud = rude
rape	v. 强奸， 洗劫	rude	a. 原始的，粗鲁的
ravish	v. 抢夺	rudimental	a. 基本的
ravage	n. 破坏

5.ras, rad = to scrape	12. rupt = to break
erase	v. 擦掉	disrupt	v. 分裂，瓦解
abrade	v. 磨损	erupt	v. 爆发，喷出
razor	n. 剃刀	interrupt	v. 打断


6．rect = straight, right	13. rus, rur = country
correct	a. 正确的	rural	a. 乡村的
rectify	v. 改正	rustic	a. 乡村的
erect	v. 竖直，竖立
7．rid, ris = laugh

ridiculous	a. 可笑的 deride	v. 嘲笑的，可笑的 risible	 a. 可笑的

S
1.sag = to know	26. somn = to sleep
sage	n. 贤人，哲人	insomnia	n. 失眠症
presage	n. 预感	somnambulate	v. 梦游

2.sal = salt	27. son = sound
salify	v. 使成盐	sonic	a. 声音的
salty	a. 咸的	supersonic	a. 超音速的

3.salv, save = to save	28. soph = wise
save	v. 挽救	sophist	n. 博学之人，诡辩家
salvation	n. 救济，救助	sophisticated	v. 精致复杂的
philosophy	n. 哲学
4．san = healthy	29. sort = kind
sane	a. 神志清醒的	assorted	a. 各种各样的
sanity	n. 精神健全	assortment	n. 分类
insane	a.	头脑不清楚的

5.sangui = blood	30. speci = to look, kind
sanguinary	a. 血淋淋的	special	a. 特别的， 专门的
sanguine	a. 血色的，乐天的	specialize	v. 专门化， 特殊化

6.sat, satis, satur = enough,	31. spect, spic = to look, full of food		to see
satisfy	v. 使满足	expect	v. 期待，盼望
satisfaction	n. 满足	inspect	v. 检查，视察
satisfactory	a. 令人满意的	perspective	n. 看法，眼界

7.scend, scens, scent = to climb	32. sper = hope
ascend	v. 登上，爬上	desperate	a. 绝望的
descend	v. 下降，传下	despair	v. 绝望
prosper	v. 繁荣

8．sci = to know	33. spers = to scatter
science	n. 科学	disperse	v. 散布，分散
conscience	n. 良心，道德心	asperse	v. 诽谤，洒水
conscientious	a. 有责任心的	aspersion	n. 诽谤，洒水

9.scribe, script = to write	34. spir = to breathe scribble	v. 乱写，涂鸦		conspire	v. 共谋

script	n. 原本，脚本	expire	v.	断气，期满
describe	v. 描写，叙述	inspire	v. 吸气，鼓励

10.secu, sequ = to follow	35. splend = to shine
sequence	n. 连续	splendid	a. 辉煌的，灿烂的
sbusequence	n. 随后发生的	splendor	n. 光辉，光彩

11.sect, seg = to cut, to divide	36. spond, spons = to promise section	n. 切开，部门		despondent	a.失望的
bisect	v. 两分	respond	v. 回答，反应

12.sens, sent = to feel	37. st, sta, stat, stan, stin sense	n. 感觉		= to stand
sensitive	a. 敏感的	stable	a. 稳定的
sentiment	n. 感情	obstacle n. 障碍

13.sen = old	38. stall = to place
senior	a. 年长的	forestall	v. 预先制止
senator	n. 参议员	install	v. 安装，就职

14．sert = to join	39. stell = star assert	v. 断言，主张		stellar	a. 星的
insert	v. 插入，抛弃	interstellar	a. 星际的

15. serv = to serve, to keep	40. still = small drop service	n. 服务		distill	v. 蒸馏
servant	n. 仆人，公务员	instill	v. 滴注
deserve	v. 值得，应受

16．set = to fix	41. stitut, stit = to set up, settle	v. 固定，安居		to place
reset	v. 重放，重排	constitute	v. 构成， 制定
upset	v. 打翻	institute	v. 制定，设立
institution	n. 制度，惯例
17．sid = to sit	42. sting, stinct, stimul = prick
reside	v. 居住	stimulate	a. 刺激，鼓励
residence	n. 居住，住宅	instigate	v. 教唆，煽动

18．sight = vision	43. strain, strict, string
insight	n. 洞察力	= to tighten
oversight	n.疏落	constrain	v. 强迫，强制
constraint	n. 约束，强制
19.sign = mark	overstrain	v. 过度紧张
signal	n. 信号

signify	v. 表示，象征

20.simil, simul, semble	44. struct = to build
=	alike, same	structure	n. 构造，结构
similar	a. 同样的，相似的	construct	v. 构造，建筑
similarity	n. 类似	destruction	n. 破坏
assimilate	v. 同化 贯通

21.sinu = to bend	45. sum = to add up sinus	n. 海湾，凹处		summation	n. 总数
sinuous	a. 蜿蜒的	summarize	v. 概括

22.sist = to stand	46. sume, sumpt = to take
assist	v. 帮助，参加	assume	v. 承担，假装，假定
assistant	n. 助手，助理	resume	v. 拿回，恢复自由等
exist	v. 存在，生存	consume	v. 消费，吃光
existence	n. 存在，生存

23．soci = companion	47. sur = sure
sociable	a. 爱社交的	assure	v. 保证，确信
social	a. 社会的	reassure	v. 使确信，使放心
insure	v. 保险，保证
24．sol = alone, sun	48. surg = to rise
sole	a. 单个的	surge	v. 浪潮，涌来
solitary	a. 孤独的	insurgent	a. 起义的，暴动的
solo	n. 独奏
solar	a. 太阳的
solarium	n. 日光浴室

25. solv, solu = to loose solve v. 解释，解决 soluble a. 可溶的

T
1.tach = nail	20. tim = to fear
attach	v. 附上，使隶属	timid	a. 胆小的
detach	v.	分开，拆开	intimidate	v. 恐吓，威胁

2.tact, tag, tig, ting = to touch	21. tir = to draw
contact	n. 接触，联系	retire	v. 退休，撤退
intact	a. 未触动的，未完整的	tirade	n. 冗长的演说
contagious	a. 传染的

3．tail = to cut	22. toler = to endure

tailor	n. 裁缝	tolerable	a. 可容忍的
curtail	v. 缩短，削减	tolerate	v. 宽容

4．tain, ten, tin = to hold	23. tom, tomy = to cut attain	v. 获得		atom	n. 原子
contain	v. 包含，包容	anatomy	n. 解剖
obtain	v. 获得，达到

5．tard = slow	24. tort = to twist
tardy	a. 缓慢的，迟的	distort	v. 歪曲
retard	v. 延迟，妨碍	retort	v. 发驳，报复

6．tect = to cover	25. touch = to touch
detect	v. 发觉，看破	touch	v. 摸，接触
detective	n. 侦探	untouchable	a. 不可接触的
protect	v. 保护，防止

7．tele = far		26. tour, torn = to turn telegram	n. 电报		tourist	n. 旅行者
telephone	n. 电话	detour	n. 曲折，迂路

8.temn, tempt = to scorn	27. tox = poison contemn	v. 蔑视，轻蔑		toxin	n. 毒素
contempt	n. 轻视	toxic	a. 有毒的
detoxify	n. 解毒
9.temper, tempor = time	28. tract = to draw temporary	a. 临时的		 abstract		a. 抽象的 contemporary	a. 当代的，同代的		attract	v. 吸引

10.tempt = to try	29. treat = to handle
attempt	v. 尝试，企图	treatment	n. 待遇，治疗
temptation	n. 诱惑	maltreat	v. 虐待

11.tend, tent, tens = to stretch	30. trem = to quiver
extend	v. 延伸，扩张	tremble	v. 发抖，摇动
extension	n. 扩张	tremor	n. 震动

12.tenu = thin	31. tribut = to give
tenuous	a. 稀薄的，细的	tribute	n. 赠品，赞扬
attenuate	v. 弄薄的，细的	contribute	v. 捐赠，贡献
distribute	v. 分配
13.term = limit	32. trop = to turn terminate	v. 终结，结束		trope	n. 转义， 比喻
determine	v. 限定，决定	tropic	n. 回归线，热带

14.terr = earth, to frighten	33.tru = true
territory	n. 领土，领域	truth	n. 事实，真理
extraterrestrial	a. 地球外的	distrust	v. 不信，猜疑
terrible	a. 可怕的	entrust	v.	委托，相信
terrorist	n. 恐怖分子

15.test = to test, to witness	34. trud, trus = to push
testify	v. 表明，证实	extrude	v. 挤出，冲出
contest	v. 比赛，竞争	intrusion	n. 侵入，干涉

16.text = to weave	35. turb = to stir
textile	n. 纺织品	disturb	v. 扰乱，打乱
texture	n. 结构，质地	turbulent	a. 骚乱的

17.thesis = setting	36. tut, tuit = to protect
thesis	n. 论文，命题	tutor	n. 保护人，导师
antithesis	n. 对立	untutored	a. 未受教育的

18.the (o) = god	37. twine = to twine theism	n. 有神论		entwine	v. 纠缠
atheism	n. 无神论	intertwine	v. 编织起来
theology	n. 神学

19.therm = heat	38. typ = type
thermos	n. 热水瓶	type	n. 种类
thermometer	n. 温度计	typewriter	n. 打字机
typical	a. 典型的

U
1.umbr = shadow	5．urb = city
umbrella	n. 伞	suburb	n. 郊区
umbra	n. 暗影	urban	a. 城市的，都市的

2.un, uni = one	6. up = up, over
unity	n. 单一，一致	uphold	v. 支持，拥护
unite	v. 团结，合并	uproot	v. 连根拔，根除
upturn	n. 价格上涨，好转
3．und = to wave	7．us, util = to use
abundant	a. 丰富的	usage	n. 用法，惯例
abound	v. 丰富，充满	usual	a. 通常的
disuse	v. 废弃不用
4.	ur = urine	misuse	v. 错用，虐待
urine	n. 尿

urology	n. 泌尿学

V
1.vac, van, void = empty	16. vestig = footprint
vacant	a. 空的，空闲的	vestige	n. 痕迹，残余
vanish	v. 不见	investigate	v. 调查

2.vad, vas = to go	17. vibr = to swing
evade	v. 逃避，偷税	vibrate	v. 振动，震动
invade	v. 侵略	vibrant	a. 震动的
pervade	v. 蔓延，普及

3.vag, vagr = to wander	18. vict, vinc = to conquer vagary	n. 妄想，狂想		victory	n. 胜利
vagabond	n. 流浪的人	convince	v. 说明，使确信
vagrant	a. 流浪的

4.vail, val = strong	19. vid, vis = to see, separate available	a. 有用的，有效的		evidence	n. 证据，证人
prevailing	a. 占优势的	visible	a. 可见的
valor	n. 英勇	vision	n.	视力，眼界
divide	v. 分开，划分
5.val, valu = value	division	n. 划分，区分
valuable	a. 有价值的
evaluate	v. 估价，评价

6.vapor =steam	20. vil = base vapor	n. 蒸汽		revile	v. 辱骂
evaporate	v.蒸发	villain	n. 坏蛋，恶棍

7.vari, vary = to change	21. vir = man
various	a. 不同的	virile	a. 男性的，阳刚的
variable	a. 易变的	virtuoso	n. 艺术大师

8.veil = to cover	22. viv, vit, vig = life
unveil	v. 揭露	vivid	a. 活泼的，生动的
reveal	v. 揭露，显示	vigor	n. 精力

9.ven, vent = wind, to come	23. voc, vok = to call, voice vent	n. 通风孔，出气孔		vocal	a. 声音的
ventilate	v. 通风	vocabulary	n. 词汇
advent	n. 到来，出现	convoke	v. 召集
event	n. 事件
invent	v. 发明

10．venge = to punish	24. vol, volunt = to wish, will avenge	v. 报仇		volition	n. 意志力 决心
revenge	v. 报仇	volunteer	n. 志愿者

11．ver = true	25. volv, volu, volt = to roll, verity	n. 真实性		to turn
verify	n. 核实，证实	volume	n. 卷，册
revolution	n. 革命
12.verb = word	involve	v. 卷入
verbal	a. 词语的
proverb	n. 格言

13.vers, vert = to turn	26. vor = to eat
convert	v. 转化，改造	voracious	a. 狼吞虎咽的
divert	v. 转向	devour	v. 吞吃
invert	v. 翻过来，倒转

14．vest = clothes	27. vulg = people
vestment	n. 衣服，外衣	vulgar	a. 大众的，粗俗的
divest	v. 脱去，剥夺	vulgarity	n. 粗俗

15．vi, via, vey, voy = way	28.vuls, vult = pluck, to tear
via	n. 道路 prep. 经过	convulse	v. 使震动，是抽搐
deviate	v. 越轨	convulsion	n. 抽搐，突然发作
convey	v. 运输

W
war = to watch
wary	a. 警惕的，谨慎的
aware	a. 意识到


Z.
1.zeal = ardor
zealot	n.	热心者
zealous	a.	热心的

2.zoo = animal zoology		n.	动物学



Affixes

A	
1.	a			6. an	不，无
(1) 不			anarchism	n.	无政府主义
acentric	a.	无中心的	anharmonic	a. 不和谐的
amoral	a.	非道德的	
(2) 在			
asleep	a.	睡着的	
aside	ad. 在边上

2.ab, abs	相反，变坏，离去	7. ante
abnormal	a.	反常的	antedate	v.	先于，早于
abuse	v.	滥用	anteroom	n.	前室

3.ac, ad, af, ag, an, ap, ar, as, at	8. anti	反对，相反一再，加强		antiwar		a.	反战的
accompany	v.	陪伴	antitank	a.	反坦克的
accustom	v.	使习惯

4.ad	做，加强	9. apo	离开，远离
adjust	v.	调整	apogee	n. 远地点
adventure	v.	冒险	apostasy	n. 背叛，脱党

5.amphi	两个，两种	10. auto
amphibian	n. 两栖动物	automatic	a. 自动的
autograph	n. 亲笔签字

B
1.be	3. bi	两，二个
(1)使成为	biweekly	n. 双周的（刊）
befool v. 欺骗	bicolor	a. 双色的
befall	v. 降临，发生
(2)构成一些介词 beside	prep. 在旁边 behind		prep. 在后边

2.bene	4. by	在旁边，副的
benevolent	a. 好意的	byproduct	n. 副产品
benefit	n. 好处，利益	byroad	n. 辅路

C.
1. circum	环绕，周围	4. com, con	 共同 circumference	n. 周长		 combine	v. 结合，联合 circumnavigate		v. 环球航行		compassion	n. 同情

2. co	共同		5. contra	反对，相反
coeducation	n. 男女同校	contrary	a. 相反的
cooperation	n. 合作	contradict	v. 反驳，矛盾

3．col, cor	共同	6. counter	反对，相反
collocate	v. 并置，并列	countercurrent	n. 逆流
collapse	v. 倒塌	counteract	v. 对抗，抵消

D
1.de	6. dia	穿过， 两者之间
(1)去掉，边坏，离开		dialogue	n. 对话 destruction	n. 破坏	diagonal	n. 对角线 detrain	v. 下火车
(2)使成为，加强 delimit		v. 划定界限 design	v. 设计，计划

2.deca	十	7. dif	不，否定，分开
decagon	n. 十角形	differ	v. 不同
decameter	n. 十米	difficult	a. 困难的

3.deci	十分之一	8. dis
decimeter	n. 十分之一米	(1)	不，消失掉
decigram	n. 十分之一克	dislike	v. 不喜欢
disorder	n. 无次序

4.demi-  半
demigod  n. 半神半人的	(2) 分开，分离
demilune  n. 半月	dispart  v. 分离
distract  v. 分开，分离
5.di-	9. dys  坏，不良
(1)双，两个	dysfunction n. 机能失调 digamist n.	 dysphonia n. 发音困难 dioxide n.
(2)使变成，变小，离开 dilute	v. 冲淡， 稀释 diminish	v. 减少，消失

E
1.e-, ef-	出，出来	5. eu-	好，优秀
emigrate	v. 移居国外	eulogize	v. 赞美
evade	v. 逃出，逃避	eugenics	n. 优生学

2.em-, en-	6. ex-

(1)进入之中，包围	(1) 出，出去
embrace	v. 拥抱	export	v. 出口
embed	v. 安置，嵌于	exclude	v. 排外
(2)使进入状态	(2)	前面的，前任的
embitter	v. 使痛苦	ex-wife	n. 前妻
encompass	v. 包围，围绕	ex-president	n. 前任总统

3.endo-	内部	7. exo- 外部的，外面
endogamy	n. 内部通婚	exogamy	n. 外族通婚
endotherm	n. 恒温动物	exocentric	a.	外乡的，离心的

4.epi-	在之上， 在后面	8. extra-	以外的，超过的
epidermal	a. 表皮的	extraordinary	a. 格外的
epidemic	a. 流行的	extrasolar	a. 太阳系以外的

F
fore- 前面，预先 forsee	v. 预见 forehead	n. 前额

H 
1.hecto	百，许多	6. holo- 全部
hectogram	n.	一百克	holography	n. 全息摄影
hectowatt	n.	一百瓦	holocaust	n. 大屠杀，大破坏


2.hemi 半	7. homo-	同类的
hemisphere	n. 半球	homogeneous	a. 同类的， 同族的
hemicycle	n. 半圆形	homocentric	a. 同中心的

3.hepta- 七	8. hyper-	超过，太多
heptagon	n. 七角形	hyperactive	a. 活动过度的
heptaglot	n. 使用七种语言	hypersensitive	a. 过敏的

4.hetero-	异类，异种	9. hypo-	下面，次等 heterosexual	a. 异性的		hypodermic	a. 皮下的 heterogeneous		a. 异教的，不同的			hypotension		n. 低血压

5.hexa	六 hexagon		n. 六角形 hexachord		n. 六弦琴

I
1.il-, ir-	4. intra- 在内，内部

(1)不，无	intraparty	a. 党内的
illegal	a. 非法的	intranational	a. 国内的
illogical	a. 不合逻辑的
(2)使成为，进入 illustrate	v. 说明，阐明 irruption	n. 闯入，冲入

2.im-, in-	5. intro-	相内，入内
(1)不，无，非			introduce		v. 介绍，引入 impossible		a. 不可能的	introspect	v. 内省，反省 immoral	a. 不道德的
(2)向内，进入 import		n. 进口 imprison		v. 监禁

3.inter- 在…之间，相互	6. iso-	等，同 international	a. 国际的	 isotherm	n. 等温线 interpersonal		a. 人与人之间的		isomorphic	a. 同形的

K
kilo- 一千
kilogram	n. 公斤
kilometer	n. 公里

M		
1. macro-	宏观，大	6. mini-	小	
macroworld	n. 宏观世界	minibus	n. 小公共汽车
macroclimate	n. 大气候	miniwar	n. 小规模战争


2.mal- 坏，恶	7. mis-	错误，坏
malcontent	a. 不满的	misspell	v. 拼写错误
malpractice	n. 不法行为	misunderstand	v. 误解

3.meta-	超过，改变	8. mono-	单个，一个
metaphysics	n. 形而上学	monarch	n. 君主，独裁者
metapsychology	n. 超心理学	monogamy	n. 一夫一妻制

4.micro-	微，小	9. multi- 多，很多
microworld	n. 微观世界	multilingual	a. 多种语言的
microbiology	n. 微生物学	multidirectional	a.多方向的

5.milli-	千，千分之一
millimeter	n. 毫米

millisecond	n. 千分之一秒

N
1. neo-	新的	2. non-	不，非
neonatal	a. 新生的，初生的	nonexistent	a. 不存在的
neogamist	n. 新婚者	nonsmoking	a. 不准吸烟的

O
1.ob	逆，倒，加强	4. out-
oblivion	n. 忘却，忘记	(1) 超过，过度
obscure	a. 模糊的	outdo	v. 胜过，战胜
outlive	v. 活得比…长
2.octa-	八	(2) 出去，过时
octagon	n. 八角形	outskirts	n. 郊区
October	n. 十月	outflow	v. 流出

3.omni-	全部，到处	5. over- omnipresent	a. 无所不在的		(1) 过度，过分
omnipotent	a. 全能的	overstudy	n. 用功过度
overwork	n. 过度劳累




(3)翻转
overturn	n. 倾覆
overthrow	v. 推翻
(2)
在…之上
overlap n./v. 重叠
overbridge	n. 天桥


P
1.paleo-	古	9. per-
paleozoology	n. 古动物学	(1) 贯穿，自始至终
paleotechnic	a. 古代技术的	perspective	n. 视角，角度
perennial	a. 全年的
2.pan-	广泛的	(2) 假，坏
pan-American	a. 泛美的	perfidy	n. 不忠，背叛
pandemic	a. 大范围流行的	perfunctory	a. 草率的

3.para-	10. peri-	周围，靠近
(1)半，类似，辅助	 perigon	n. 周角 paramilitary	a. 准军事性的	periderm		n. 表皮 parapolitical	 n. 半政治的
(2)在旁边	11. poly-	多
paralyze	v. 瘫痪	polygamy	n. 一夫多妻制
paragon	n. 典范	polygon	n. 多角形
(3)降落伞

paratroops	n. 伞兵部队
paradrop	n. 空投，空降

4.pen-		近似，差不多	12.	post- peninsula	n. 半岛		(1) 在后面
penumbra	n. 半阴影	postwar	a. 战后的
(2)邮件，邮政
5.penta-	五	postage	n. 邮资
pentagon	n. 五角形， 五角大楼	postcard	n. 明信片
pentagram	n. 五角星形

6.pre	前的，预先	13. pro-
preschool		n. 学龄前	(1) 向前，在前 prehistory			n. 史前		progress	n. 进步 prolong	v. 延长
7.proto	原始	(2) 很多
protozoon	n. 原生动物	prolific	a. 多产的
protohuman	a. 早期原始人的	prosperous	a. 兴旺的
(3)赞同，亲
8.pseudo- 假，伪	pro-American	a. 亲美的
pseudonym	n. 假名，笔名	proslavery n.赞成奴隶制的 pseudoscience	a. 伪科学


Q.
1. quadric-	四	2. quasi- 准
quadrangle	n. 四角形	quasi-official	n. 半官方的
quadricycle	n. 四轮车	quasi-war	n. 准战争

R
1.re-	2. retro- 向后，倒退
(1)向后，相反	retrograde v. 后退，倒退 recall v. 回忆		retrogress v. 倒退，退化 reflect v. 回想，反射
(2)一再， 重新 reappear	v. 再出现 rearrange		v. 重新安排

S
1.se- 分开，离开，区别开	9. supra-  超
secede		v. 正式退出组织		supra-class	a.抄阶级的 select	v. 选出	supranational a.超国家的

2.semi- 半	10. sur-	超过，在上面

semimonthly	n. 半月刊	surface	n. 表面
semicircle	n. 半圆	surpass	v. 超过

3.sept- 七	11. super-
septangle	n. 七角形	(1) 超级，超过，过度
September	n. 九月（古罗马的七月）	supersonic	a. 超音速的
supernatural	a.超自然的
4.sex- 六	(2) 在上面
sexangle	n. 六角形	superstructure	n. 上层建筑
sexdigital	a. 六指的	superimpose	v. 强加

5.step- 后，继或前夫所生的	12. sus- 在下面
stepfather	n. 继父	sustain	v. 支撑，承受
suspend	v. 悬挂，中止
6.stereo- 立体	13. syn-, syn- 共同，相同
stereosonic	a. 立体声的	sympathy	n. 同情
sterograph	n. 立体照片	symphony	n. 交响乐

7.sub-
(1)在下面，次一等，副手 submerge	v. 沉没，淹没 subordinate		a. 附属的
(2)接近，靠近
subcentral	a. 接近中心的
subadult	a. 接近成年的

8.suc, suf, sup, sur, sus 在下面
suffer	v. 受苦
supplant	v. 排挤，取代

T
1.tetra-	四	3. tri-	三
tetragon	n.四角性	triangle	n. 三角形

2.trans-	4. twi- 二，两
(1)横过，越过	 twilight	 n. 黎明，黄昏 transparent	a. 透明的	twofold	n. 两倍 transmit	v. 传播，传送
(2)变换，改变 transform	v. 变形 transplant	 v. 移植

U
1.ultra-	3. under-

(1)极端	(1) 在下面，在之内
ultramilitant	a. 极端好战的	underground	a. 地下的
ultraclean	a. 极洁净的	underline	v. 划线于
(2)超出，超过	(2) 不足，不够
ultrasonic	a. 超音速的	underestimate	v. 估计不足
ultramodern	a. 超现代化	underdeveloped	a.不发达的 (3)副手
2.un-	underagent	n. 副代理人
(1)不，非，无		underofficer	n.下级官员 unreal	a. 不真实的	4. uni- 一个，单一
unequal	a. 不平等的	uniform	a. 一贯的，一致的
(2)打开，解开，弄开	unique	a. 独一无二的
unlock	v. 开锁
unbind	v. 解开

V
vice-	副
vice-president	n. 副总统

W
with-	相后，相反 withdraw		v. 撤消，撤退 withhold	v. 阻止

Prefixes
A
1. –ability	能，性	17. –an	…地方，…样人 useability	n. 可用性		American	a./n.美洲的，美洲人 adaptability		n. 适应能力			republican a./n. 共和国的

2．-able 可…的，能	18. –ance	性质，状况
knowable	a. 可知的	disturbance	n. 扰乱
desirable	a. 值得要的	resemblance	n. 想像

3.–ably	能…地	19. –ancy	性质，状况
suitably	ad. 恰当地	redundancy	n. 过剩
lovably	ad. 可爱地	vacancy	n. 空白，空缺

4.-aceous	具有特征的	20. – aneity 性质，状态
herbaceous	a. 草本植物	instantaneity	n. 立刻
papyraceous	a. 似纸的	simultaneity	n. 同时发生

5.-acious	有特征的	21. –aneous 有特征的

capacious	a. 宽敞的	simultaneous	a.同时发生的
veracious	a. 真实的	subterraneous	a.地下的
6．-acity	有…倾向	22. - ant
capacity	n. 容量，能力	(1) …的
veracity	n. 真实	discordant	a. 不一致的
resistant	a. 抵抗的
7. –acle	…物品，状态	(2) …人
miracle	n. 奇迹	assistant	n. 助手
obstacle	n. 障碍	inhabitant	n. 居民
(3)…剂
8.	–acy	性质，状态	disinfectant	n.消毒剂
fallacy	n. 错误	stimulant	n. 兴奋剂
intimacy	n. 亲密

9.-ad	状态，…东西	23. -ar
balled	n. 歌谣，歌曲	(1) …的
nomad	n. 流浪者，游牧人	liner	a. 线的
familiar	a. 熟悉的
10.–ade	(2) 人，物
(1)状态，物品	liar	n. 说谎者
blockade	n. 封锁	beggar	n. 乞丐
decade	n. 十年	24. -ard 不好的人
(2)个人或集体	drunkard	n. 醉鬼
brigade	n. 旅，队	coward	n. 胆小者
crusade	n. 十字军

11.–age	25. –arian	…的人
(1)状态，总称	humanitarian	n. 人道主义的人
percentage		n. 百分比	utilitarian	n.功利主义的人 adventage	n. 利益
(2)场所，物品	26. –arium	地点，场所
village	n. 村庄	aquarium	n. 水族馆
collage	n. 村舍	oceanarium	n. 海洋水族馆
(3)费用	27. -ary
postage	n. 邮费	(1) …的
waterage	n. 水运费	imaginary	a. 想象的
elementary	a. 基本的
12．-ain	人	(2) … 人
captain	n. 船长	secretary	n. 秘书
chieftain	n. 酋长，头目	missionary	n. 传教士

13.- aire	人	28. –ast 人，物
millionaire	n. 百万富翁	enthusiast	n. 热心者

occupationaire	n.占领者	encomiast	n.	赞美者

14.-al	29. –aster 不怎么样的人
(1)…的		philosophaster		n. 肤浅哲学家 personal	 a. 个人的	medicaster	n.	江湖医生 regional	a. 地区性的
(2)人，物， 状态	30. - ate criminal	n. 犯罪分子		(1) 做，造成
hospital	n. 医院	differentiate	v. 区别
(2) 具有…的
15．-ality	状态，性质		considerate	a.考虑周到的 personality		n. 人格，个性	(3) 人或地位
nationality	n. 国籍	graduate	n. 毕业生

16．-ally …地	31. –atic 有…性质的
systenatucakkt	ad. 有系统地	fanatic	a. 狂热的
exceptionally	ad. 例外	problematic	a.与问题的



excitation	n. 兴奋
imagination	n. 想象

32. –ation




talkative	a. 好说话的

34.–ator 做事的人或物 designator		n. 指定者 generator	n. 发电机

35．- atory
(1)有…性质的 obligatory	a. 义务的 explanatory		a. 解释的

observatory		n.天文台 laboratory	n. 实验室

33. –ative 有…倾向（性质的）









(2)场所，地点


C
- cy	性质，状态
emergency	n. 紧急事件
bankruptcy	n. 破产

D
- dom 状态或领域

freedom		n.自由 wisdom	n.智慧

E
1.–ee 被动或主动的人	11.- ern emplyee	n. 雇员		(1)方向
trainee	n. 受训练者	eastern	a. 东方的
(2)场所
2.–eer 专门人员			cavern	n. 洞穴 mountaineer	n. 登山者	saltern	n. 盐场 engineer		n. 工程师

3.	–el 人或物	12. - ery
parcel	n.包裹	(1) 场所，地点
nooel	n.小说	nursery	n. 托儿所
personnel	n.全体人员	rosery	n. 玫瑰园
(2) 行为，情况
4.–en	robbery	n.抢劫
(1)变成	bravery	n. 勇敢
shorten	v.缩短
darken	v. 变黑	13. –esque 如…的
(2)由…制成的		arabesque	a.阿拉伯式的 wooden		a. 木制的	picturesque	a. 如画的 woolen	a. 羊毛制的
(3)人或物 citizen	n.公民 warden		n. 看守人

5.–ence 性质，状态	14. –ess 女性，雌性
insistence	n. 坚持	poetess	n. 女诗人
innocence	n. 天真，有罪	mayoress	n.	市长夫人

6.	–ency 是 ence 的变体
efficiency	n.效率 persistency		n. 坚持	15.	–et (-let) 小东西
floweret	n. 小花
lionet	n. 小狮

7．- enne 女性
comedienne	

n.女喜剧演员	
16. –etic 属于…的
theoretic	a. 理论上的
tragedienne	n. 女悲剧演员	energetic	a. 精力旺盛的

8．- ent	17. –ette 小的东西或状态
(1)…的	novelette	n. 中篇小说
confident	a.自信的	cigarette	n. 香烟
insistent	a. 坚持的

(2)…药剂	18. –ety 状态
absorbent	n. 吸收剂	gaiety	n. 快乐
solvent	n. 溶剂	propriety	n. 适合，得体
(3)…人 student	n. 学生
president	n. 总统

9.–eous	19. –eur …人
courteous	a. 有礼貌的	amateur	n. 业余爱好这
erroneous	a. 有错误的	entrepreneur	n. 企业家

10．-er
(1)…人
singer	 n.歌唱家 leader	n. 领袖
(2)物品，机器 washer		n. 洗刷机 lighter	n. 打火机
(3)发复做 chatter			v.喋喋不休 waver	v. 摆动

F
1. –faction 达到的状态	5. –fold 倍，双重
satisfaction	n. 满足	twofold	ad. 两倍的
rarefaction	n. 稀薄	threefold	ad. 三倍的
2．-fic 产生…的	6. –form 有…形状的
scientific	a. 科学的	dentiform	a. 牙齿状的
horrific	a. 可怕的	uniform	a.一致的

3.–fication 由 fic 变化而来	7. -ful beautification	n. 美化		(1) 有…的
glorification	n. 颂扬	grateful	a.感激的 willful	a. 任性的
4.–fier 人或物	(2) 满，量
glorifier	n. 颂扬者	handful	n. 一 把
liquefier	n. 液化器	mouthful	n. 一口
8. –fy …化，成为…
fruitify	v. 结果化
beautify	v. 美化

H
- hood	时期，性质
childhood	n. 童年

I
1.–ia	18. -ious
(1)某种病	curious	a.好奇的
insomnia		n. 失眠症	spacious	a.宽敞的 euphoria	n. 欣快病
(2)总称， 状态	19. -ise
militia	n. 自卫队	(1)-ize…化
utopia	n. 乌托邦	criticise v.批评
advertise	v.做广告
2.–ial 有…的	(2)物品，状态
beneficial	a. 有好处的	surmise	n.猜测
commercial	a. 商业的	exercise	n.练习，锻炼

3.–ian	20. -ish
(1)某种人	(1) 象…一样，有的…
historian	n.历史学家	childish	a.孩子气的 comedian		n.喜剧演员		bookish		a. 书生气的
(2)…国家的	(2) 造成
Egyptian	a. 埃及的	polish	v 擦亮
Canadian	a. 加拿大		flourish	v.繁荣 (3)国家的或语言
4.–ibility 具备			English	a./n.英国（的） compatibility	n.和谐共处	Irish	a./n. 爱尔兰的（语） sensibility	n.敏感性

5.–ible 能…的	21. -ism
intelligible	a.可理解的	(1)各种主义，宗教
sensible	a.明智的	opportunism	n.机会主义 idealism	n.唯心主义
6.-ic	(2)学术或学术流派
(1)…的	modernism	n.现代派
fanatic	a.狂热的	impressionism	n. 印象派
cosmic	a.宇宙的	(3) 行为，想象，状态
(2)人或科学	escapism		n.逃避现实 critic	n.批评家		tourism	n.旅游
logic	n.逻辑学	(4) 疾病
(3)某种药	alcoholism	n.酒精中毒病
anesthetic		n.麻醉剂		albinism	n.白化病 antibiotic	n.抗生素	(5)具备某种性质
humanism	n.人性
7.–ical …的	brutalism	n.兽性
symmetrical		a.对称的 geometrical	a.几何学的

8.–ice	行为，状态	22. –ist 信仰者，专家
artifice	n.巧办法，诡计	nationalist	n. 民族主义者
armistice	n.休战	materialist	n.物质主义者

9.–ics	学科，学术	23. -istic
metaphysics	n.形而上学	simplistic	a.过分简单的
linguistics	n. 语言学	artistic	a.艺术的

10.–id 如…的	24. -it
splendid		a.辉煌的	(1)抽象名词 humid	a. 潮湿的		spirit	n.精神
credit	n.相信
11.–ie 小东西或人	(2)…人
doggie	n. 小狗	hermit	n.隐士
piggie	n.小猪	bandit	n. 匪徒

12.	–ier 人或物	25. -ite	
cashier	n.出纳	(1) 有…的		
frontier	n.边疆	polite	a.	礼貌的
definite	a. 明确的
13．-ile	(2)人或物
(1)…的	favorite	n. 喜爱的人或物
merchantile	a. 商人的	elite	n. 社会精英
fertile	a. 肥沃的	(3) 促成
(2)物体	ignite	v. 点燃
missile	n.发射物，导弹	unite	v.联合 automobile	n.汽车

14.–ine	26.-ition 行为过程，状态
(1)…的	definition	n.定义
elephantine	a. 如象的，巨大的	repetition	n.重复 marine	a. 海的
(2)人	27. –itious …的
figurine	n.小雕像	expeditious	a.快速的
heroine	n.女英雄	nutritious	a. 有营养的
(3)状态，药物 famine	n. 饥荒 routine	 n. 常规

15.–ing	28. –itive	…的
(1)状态	compositive	a.合成的
feeling	 n.感情	dompetitive	a.比赛的 ageing	n. 老化

(2)物品	29. –itor 人
clothing	n.衣服	competitor	n.比赛者
building	n.建筑物	expositor	n.讲解者 (3)行业
fishing	n. 渔业	30. –itude 性质，状态等
banking	n.银行业	attitude	n. 态度
(4)正…的，令人…的	solitude	n. 孤独
encouraging	a.鼓舞人心的
changing	a.正在变化的	31. –ity 具备某种性质
complexity	n. 复杂性
16.–ion (sion, tion)	equality	n. 平等
(1)动作的状态
obligation	n. 责任	32. -ive
inflation	n. 通货膨胀	(1)sive, ative, ive, itive
(2)某种物，用品		impassive	a.无动于衷的 cushion	n.靠垫	affirmative	a.赞同的
mansion	n.大厦	(2)人或物
detective	n.侦探
17.–ior 较…的	fugitive	n.逃亡
interior	a.内部的
superior	a.在上面的，超越的	33.-ivity 有能力或特性
productivity	n.生产力 activity	n.活动
34.-ization
modernization	n. 现代化
industrialization	n. 工业化

K
-kin 小
manikin		n.侏儒 ladykin	n. 小妇人

L
1.–less 无…的，不…的	4. -ly
nerveless	 a. 无勇气的	(1)加在名词后，表形容词 effortless	a. 不费力的		timely	a. 及时的
lively	a. 活跃的
2.–like 像…一样	(2)加在形容词后，表副词 dreamlike	a. 如梦般的		extremely	ad. 过分地
womanlike	a. 女人气的	greatly	ad. 很大地

3.–ling 小东西或某种人
birdling	n.小鸟 weakling		n. 体弱的人

M
1.–ment	2. –most 最…的
(1)行为或结果		outmost		a.最外面的 movement	 n.运动	easternmost	a.最东的 agreement	n. 协议
(2)具体物 pavement	n.人行道 equipment		n. 设备

N
- ness	性质，状态 forwardness	n. 大胆，鲁莽 positiveness	 n.肯定

O
1.–0	6. –ose	多的
(1)人、物或状态		bellicose a. 好战的 virtuoso	n. 艺术大师	jocose		a. 好开玩笑的 magnifico		n. 高官，贵人
(2)音乐术语	7. –osity 多的状态
tangeo	n. 探戈舞	curiosity	n. 好奇心
piano	n. 钢琴	generosity	n. 慷慨

2.–on	人或物理上的名词		8. –ot …人 patron	n. 赞助人		zealot		n.热心者
neutron	n. 中子	partriot	n. 爱国者
3.–oon 人或物		9. –ous …的 tycoon	n.大亨	dangerous	a.危险的
balloon	n.气球	mountainous	a. 多山的

4.–or 人或物器 detector		n. 探测器 compressor	n. 压缩机

5.–ory
(1)…的
advisory	a. 劝告的
compulsory	a. 强制性的
(2)场所等 factory	n. 工厂 armory	 n. 军诫库

P

-proof 防…的 waterproof		a. 防水的 rainproof	a. 防雨的

R
1.–ress	2. - ry
(1)女性	(1) 状态，性质
waitress	n. 女服务员	rivalry	n. 竞争，敌对
actress	n. 女演员	artistry	n. 艺术性
(2)物品	(2) 行业，学科
fortess	n. 堡垒	forestry	n. 林学
mattress	n. 床垫	chemistry	n.化学
(3)集合名词
poetry	n.诗歌 citizenry		n. 公民
(4)场地
laundry	n. 洗衣房
ferry	n.	渡口

S
1.–ship	3. –ster …人
(1)某种状态	pollster	n. 民意测验家
friendship		n. 友谊	songster	n.歌唱家 hardship	n. 苦难
(2)某种技能 airmanship	n. 飞行技术 salesmanship		n. 推销术
2.	–some 充满…的，具有…倾向的 quarrelsome	a. 好争吵的 lonesome	a. 孤独的

T
1.–th 抽象名词	3. –ture 一般状态，行为
warmth	n. 温暖	miniature	n.小画像
growth	n.	成长	legislature	n.立法机关

2.-tic 与…相关的	4. – ty 把形容词变成名词
romantic	a. 浪漫的	safety	n. 安全
dramatic	a. 戏剧性的	certainty	n. 肯定

U
1.–ular 有…形状或性质的	3. –uous	多…的
globular	a. 球形的	innocuous	a.（言、行）无害的
spectacular	a. 壮观的	assiduous	a.勤勉的

2.–ule 小
granule	n. 微粒
globule	n. 小球的

W
1.–ward 向	2. – wise 方向，状态
downward	a./ad. 向下的	crosswise	ad. 交叉地
upward	a./ad. 向上的	coastwise	ad. 沿海地

Y
-y
(1)加在名词后变形容词
rainy	a. 下雨的
homey	a. 象家一样的
(2)在形容词或以 r 结尾的单词
difficulty	n. 困难 discovery		n. 发现 (3)人或小东西
fatty	n. 胖子
shorty	n. 矮子